64
cycle 3 2 78
1 1 1 2 1 1 3 1 1 1 3 1 1 2 1 1 1 2 1 1 3 1 1 1 3 1 1 2 1 1 1 2 1 1 3 3 0 0 2 0
0 0 2 0 0 3 0 0 0 3 0 0 2 0 0 0 2 0 0 3 0 0 0 3 0 0 2 0 0 0 2 0 0 3 3 1 1 2
cycle 4 2 78
1 1 2 1 1 3 1 1 1 3 1 1 2 1 1 1 2 1 1 3 1 1 1 3 1 1 2 1 1 1 2 1 1 3 3 0 0 2 0
0 0 2 0 0 3 0 0 0 3 0 0 2 0 0 0 2 0 0 3 0 0 0 3 0 0 2 0 0 0 2 0 0 3 3 1 1 2 1
cycle 5 2 78
1 2 1 1 3 1 1 1 3 1 1 2 1 1 1 2 1 1 3 1 1 1 3 1 1 2 1 1 1 2 1 1 3 3 0 0 2 0
0 0 2 0 0 3 0 0 0 3 0 0 2 0 0 0 2 0 0 3 0 0 0 3 0 0 2 0 0 0 2 0 0 3 3 1 1 2 1 1
cycle 6 2 78
2 1 1 3 1 1 1 3 1 1 2 1 1 1 2 1 1 3 1 1 1 3 1 1 2 1 1 1 2 1 1 3 3 0 0 2 0
0 0 2 0 0 3 0 0 0 3 0 0 2 0 0 0 2 0 0 3 0 0 0 3 0 0 2 0 0 0 2 0 0 3 3 1 1 2 1 1 1
cycle 6 1 78
1 1 3 1 1 1 3 1 1 2 1 1 1 2 1 1 3 1 1 1 3 1 1 2 1 1 1 2 1 1 3 3 0 0 2 0
0 0 2 0 0 3 0 0 0 3 0 0 2 0 0 0 2 0 0 3 0 0 0 3 0 0 2 0 0 0 2 0 0 3 3 1 1 2 1 1 1 2
cycle 7 1 78
1 3 1 1 1 3 1 1 2 1 1 1 2 1 1 3 1 1 1 3 1 1 2 1 1 1 2 1 1 3 3 0 0 2 0
0 0 2 0 0 3 0 0 0 3 0 0 2 0 0 0 2 0 0 3 0 0 0 3 0 0 2 0 0 0 2 0 0 3 3 1 1 2 1 1 1 2 1
cycle 8 1 78
3 1 1 1 3 1 1 2 1 1 1 2 1 1 3 1 1 1 3 1 1 2 1 1 1 2 1 1 3 3 0 0 2 0
0 0 2 0 0 3 0 0 0 3 0 0 2 0 0 0 2 0 0 3 0 0 0 3 0 0 2 0 0 0 2 0 0 3 3 1 1 2 1 1 1 2 1 1
cycle 8 2 78
1 1 1 3 1 1 2 1 1 1 2 1 1 3 1 1 1 3 1 1 2 1 1 1 2 1 1 3 3 0 0 2 0
0 0 2 0 0 3 0 0 0 3 0 0 2 0 0 0 2 0 0 3 0 0 0 3 0 0 2 0 0 0 2 0 0 3 3 1 1 2 1 1 1 2 1 1 3
cycle 3 7 78
1 1 1 2 1 1 3 1 1 1 3 1 1 2 1 1 1 2 1 1 3 1 1 1 3 1 1 2 1 1 1 2 1 1 3 3 0 0 2 0
0 0 2 0 0 3 0 0 0 3 0 0 2 0 0 0 2 0 0 3 0 0 0 3 0 0 2 0 0 0 2 0 0 3 3 1 1 2
cycle 4 7 78
1 1 2 1 1 3 1 1 1 3 1 1 2 1 1 1 2 1 1 3 1 1 1 3 1 1 2 1 1 1 2 1 1 3 3 0 0 2 0
0 0 2 0 0 3 0 0 0 3 0 0 2 0 0 0 2 0 0 3 0 0 0 3 0 0 2 0 0 0 2 0 0 3 3 1 1 2 1
cycle 5 7 78
1 2 1 1 3 1 1 1 3 1 1 2 1 1 1 2 1 1 3 1 1 1 3 1 1 2 1 1 1 2 1 1 3 3 0 0 2 0
0 0 2 0 0 3 0 0 0 3 0 0 2 0 0 0 2 0 0 3 0 0 0 3 0 0 2 0 0 0 2 0 0 3 3 1 1 2 1 1
cycle 6 7 78
2 1 1 3 1 1 1 3 1 1 2 1 1 1 2 1 1 3 1 1 1 3 1 1 2 1 1 1 2 1 1 3 3 0 0 2 0
0 0 2 0 0 3 0 0 0 3 0 0 2 0 0 0 2 0 0 3 0 0 0 3 0 0 2 0 0 0 2 0 0 3 3 1 1 2 1 1 1
cycle 6 6 78
1 1 3 1 1 1 3 1 1 2 1 1 1 2 1 1 3 1 1 1 3 1 1 2 1 1 1 2 1 1 3 3 0 0 2 0
0 0 2 0 0 3 0 0 0 3 0 0 2 0 0 0 2 0 0 3 0 0 0 3 0 0 2 0 0 0 2 0 0 3 3 1 1 2 1 1 1 2
cycle 7 6 78
1 3 1 1 1 3 1 1 2 1 1 1 2 1 1 3 1 1 1 3 1 1 2 1 1 1 2 1 1 3 3 0 0 2 0
0 0 2 0 0 3 0 0 0 3 0 0 2 0 0 0 2 0 0 3 0 0 0 3 0 0 2 0 0 0 2 0 0 3 3 1 1 2 1 1 1 2 1
cycle 8 6 78
3 1 1 1 3 1 1 2 1 1 1 2 1 1 3 1 1 1 3 1 1 2 1 1 1 2 1 1 3 3 0 0 2 0
0 0 2 0 0 3 0 0 0 3 0 0 2 0 0 0 2 0 0 3 0 0 0 3 0 0 2 0 0 0 2 0 0 3 3 1 1 2 1 1 1 2 1 1
cycle 8 7 78
1 1 1 3 1 1 2 1 1 1 2 1 1 3 1 1 1 3 1 1 2 1 1 1 2 1 1 3 3 0 0 2 0
0 0 2 0 0 3 0 0 0 3 0 0 2 0 0 0 2 0 0 3 0 0 0 3 0 0 2 0 0 0 2 0 0 3 3 1 1 2 1 1 1 2 1 1 3
cycle 3 12 78
1 1 1 2 1 1 3 1 1 1 3 1 1 2 1 1 1 2 1 1 3 1 1 1 3 1 1 2 1 1 1 2 1 1 3 3 0 0 2 0
0 0 2 0 0 3 0 0 0 3 0 0 2 0 0 0 2 0 0 3 0 0 0 3 0 0 2 0 0 0 2 0 0 3 3 1 1 2
cycle 4 12 78
1 1 2 1 1 3 1 1 1 3 1 1 2 1 1 1 2 1 1 3 1 1 1 3 1 1 2 1 1 1 2 1 1 3 3 0 0 2 0
0 0 2 0 0 3 0 0 0 3 0 0 2 0 0 0 2 0 0 3 0 0 0 3 0 0 2 0 0 0 2 0 0 3 3 1 1 2 1
cycle 5 12 78
1 2 1 1 3 1 1 1 3 1 1 2 1 1 1 2 1 1 3 1 1 1 3 1 1 2 1 1 1 2 1 1 3 3 0 0 2 0
0 0 2 0 0 3 0 0 0 3 0 0 2 0 0 0 2 0 0 3 0 0 0 3 0 0 2 0 0 0 2 0 0 3 3 1 1 2 1 1
cycle 6 12 78
2 1 1 3 1 1 1 3 1 1 2 1 1 1 2 1 1 3 1 1 1 3 1 1 2 1 1 1 2 1 1 3 3 0 0 2 0
0 0 2 0 0 3 0 0 0 3 0 0 2 0 0 0 2 0 0 3 0 0 0 3 0 0 2 0 0 0 2 0 0 3 3 1 1 2 1 1 1
cycle 6 11 78
1 1 3 1 1 1 3 1 1 2 1 1 1 2 1 1 3 1 1 1 3 1 1 2 1 1 1 2 1 1 3 3 0 0 2 0
0 0 2 0 0 3 0 0 0 3 0 0 2 0 0 0 2 0 0 3 0 0 0 3 0 0 2 0 0 0 2 0 0 3 3 1 1 2 1 1 1 2
cycle 7 11 78
1 3 1 1 1 3 1 1 2 1 1 1 2 1 1 3 1 1 1 3 1 1 2 1 1 1 2 1 1 3 3 0 0 2 0
0 0 2 0 0 3 0 0 0 3 0 0 2 0 0 0 2 0 0 3 0 0 0 3 0 0 2 0 0 0 2 0 0 3 3 1 1 2 1 1 1 2 1
cycle 8 11 78
3 1 1 1 3 1 1 2 1 1 1 2 1 1 3 1 1 1 3 1 1 2 1 1 1 2 1 1 3 3 0 0 2 0
0 0 2 0 0 3 0 0 0 3 0 0 2 0 0 0 2 0 0 3 0 0 0 3 0 0 2 0 0 0 2 0 0 3 3 1 1 2 1 1 1 2 1 1
cycle 8 12 78
1 1 1 3 1 1 2 1 1 1 2 1 1 3 1 1 1 3 1 1 2 1 1 1 2 1 1 3 3 0 0 2 0
0 0 2 0 0 3 0 0 0 3 0 0 2 0 0 0 2 0 0 3 0 0 0 3 0 0 2 0 0 0 2 0 0 3 3 1 1 2 1 1 1 2 1 1 3
cycle 3 17 78
1 1 1 2 1 1 3 1 1 1 3 1 1 2 1 1 1 2 1 1 3 1 1 1 3 1 1 2 1 1 1 2 1 1 3 3 0 0 2 0
0 0 2 0 0 3 0 0 0 3 0 0 2 0 0 0 2 0 0 3 0 0 0 3 0 0 2 0 0 0 2 0 0 3 3 1 1 2
cycle 4 17 78
1 1 2 1 1 3 1 1 1 3 1 1 2 1 1 1 2 1 1 3 1 1 1 3 1 1 2 1 1 1 2 1 1 3 3 0 0 2 0
0 0 2 0 0 3 0 0 0 3 0 0 2 0 0 0 2 0 0 3 0 0 0 3 0 0 2 0 0 0 2 0 0 3 3 1 1 2 1
cycle 5 17 78
1 2 1 1 3 1 1 1 3 1 1 2 1 1 1 2 1 1 3 1 1 1 3 1 1 2 1 1 1 2 1 1 3 3 0 0 2 0
0 0 2 0 0 3 0 0 0 3 0 0 2 0 0 0 2 0 0 3 0 0 0 3 0 0 2 0 0 0 2 0 0 3 3 1 1 2 1 1
cycle 6 17 78
2 1 1 3 1 1 1 3 1 1 2 1 1 1 2 1 1 3 1 1 1 3 1 1 2 1 1 1 2 1 1 3 3 0 0 2 0
0 0 2 0 0 3 0 0 0 3 0 0 2 0 0 0 2 0 0 3 0 0 0 3 0 0 2 0 0 0 2 0 0 3 3 1 1 2 1 1 1
cycle 6 16 78
1 1 3 1 1 1 3 1 1 2 1 1 1 2 1 1 3 1 1 1 3 1 1 2 1 1 1 2 1 1 3 3 0 0 2 0
0 0 2 0 0 3 0 0 0 3 0 0 2 0 0 0 2 0 0 3 0 0 0 3 0 0 2 0 0 0 2 0 0 3 3 1 1 2 1 1 1 2
cycle 7 16 78
1 3 1 1 1 3 1 1 2 1 1 1 2 1 1 3 1 1 1 3 1 1 2 1 1 1 2 1 1 3 3 0 0 2 0
0 0 2 0 0 3 0 0 0 3 0 0 2 0 0 0 2 0 0 3 0 0 0 3 0 0 2 0 0 0 2 0 0 3 3 1 1 2 1 1 1 2 1
cycle 8 16 78
3 1 1 1 3 1 1 2 1 1 1 2 1 1 3 1 1 1 3 1 1 2 1 1 1 2 1 1 3 3 0 0 2 0
0 0 2 0 0 3 0 0 0 3 0 0 2 0 0 0 2 0 0 3 0 0 0 3 0 0 2 0 0 0 2 0 0 3 3 1 1 2 1 1 1 2 1 1
cycle 8 17 78
1 1 1 3 1 1 2 1 1 1 2 1 1 3 1 1 1 3 1 1 2 1 1 1 2 1 1 3 3 0 0 2 0
0 0 2 0 0 3 0 0 0 3 0 0 2 0 0 0 2 0 0 3 0 0 0 3 0 0 2 0 0 0 2 0 0 3 3 1 1 2 1 1 1 2 1 1 3
cycle 26 2 78
0 0 0 2 0 0 3 0 0 0 3 0 0 2 0 0 0 2 0 0 3 0 0 0 3 0 0 2 0 0 0 2 0 0 3 3 1 1 2 1
1 1 2 1 1 3 1 1 1 3 1 1 2 1 1 1 2 1 1 3 1 1 1 3 1 1 2 1 1 1 2 1 1 3 3 0 0 2
cycle 25 2 78
0 0 2 0 0 3 0 0 0 3 0 0 2 0 0 0 2 0 0 3 0 0 0 3 0 0 2 0 0 0 2 0 0 3 3 1 1 2 1
1 1 2 1 1 3 1 1 1 3 1 1 2 1 1 1 2 1 1 3 1 1 1 3 1 1 2 1 1 1 2 1 1 3 3 0 0 2 0
cycle 24 2 78
0 2 0 0 3 0 0 0 3 0 0 2 0 0 0 2 0 0 3 0 0 0 3 0 0 2 0 0 0 2 0 0 3 3 1 1 2 1
1 1 2 1 1 3 1 1 1 3 1 1 2 1 1 1 2 1 1 3 1 1 1 3 1 1 2 1 1 1 2 1 1 3 3 0 0 2 0 0
cycle 23 2 78
2 0 0 3 0 0 0 3 0 0 2 0 0 0 2 0 0 3 0 0 0 3 0 0 2 0 0 0 2 0 0 3 3 1 1 2 1
1 1 2 1 1 3 1 1 1 3 1 1 2 1 1 1 2 1 1 3 1 1 1 3 1 1 2 1 1 1 2 1 1 3 3 0 0 2 0 0 0
cycle 23 1 78
0 0 3 0 0 0 3 0 0 2 0 0 0 2 0 0 3 0 0 0 3 0 0 2 0 0 0 2 0 0 3 3 1 1 2 1
1 1 2 1 1 3 1 1 1 3 1 1 2 1 1 1 2 1 1 3 1 1 1 3 1 1 2 1 1 1 2 1 1 3 3 0 0 2 0 0 0 2
cycle 22 1 78
0 3 0 0 0 3 0 0 2 0 0 0 2 0 0 3 0 0 0 3 0 0 2 0 0 0 2 0 0 3 3 1 1 2 1
1 1 2 1 1 3 1 1 1 3 1 1 2 1 1 1 2 1 1 3 1 1 1 3 1 1 2 1 1 1 2 1 1 3 3 0 0 2 0 0 0 2 0
cycle 21 1 78
3 0 0 0 3 0 0 2 0 0 0 2 0 0 3 0 0 0 3 0 0 2 0 0 0 2 0 0 3 3 1 1 2 1
1 1 2 1 1 3 1 1 1 3 1 1 2 1 1 1 2 1 1 3 1 1 1 3 1 1 2 1 1 1 2 1 1 3 3 0 0 2 0 0 0 2 0 0
cycle 21 2 78
0 0 0 3 0 0 2 0 0 0 2 0 0 3 0 0 0 3 0 0 2 0 0 0 2 0 0 3 3 1 1 2 1
1 1 2 1 1 3 1 1 1 3 1 1 2 1 1 1 2 1 1 3 1 1 1 3 1 1 2 1 1 1 2 1 1 3 3 0 0 2 0 0 0 2 0 0 3
cycle 26 7 78
0 0 0 2 0 0 3 0 0 0 3 0 0 2 0 0 0 2 0 0 3 0 0 0 3 0 0 2 0 0 0 2 0 0 3 3 1 1 2 1
1 1 2 1 1 3 1 1 1 3 1 1 2 1 1 1 2 1 1 3 1 1 1 3 1 1 2 1 1 1 2 1 1 3 3 0 0 2
cycle 25 7 78
0 0 2 0 0 3 0 0 0 3 0 0 2 0 0 0 2 0 0 3 0 0 0 3 0 0 2 0 0 0 2 0 0 3 3 1 1 2 1
1 1 2 1 1 3 1 1 1 3 1 1 2 1 1 1 2 1 1 3 1 1 1 3 1 1 2 1 1 1 2 1 1 3 3 0 0 2 0
cycle 24 7 78
0 2 0 0 3 0 0 0 3 0 0 2 0 0 0 2 0 0 3 0 0 0 3 0 0 2 0 0 0 2 0 0 3 3 1 1 2 1
1 1 2 1 1 3 1 1 1 3 1 1 2 1 1 1 2 1 1 3 1 1 1 3 1 1 2 1 1 1 2 1 1 3 3 0 0 2 0 0
cycle 23 7 78
2 0 0 3 0 0 0 3 0 0 2 0 0 0 2 0 0 3 0 0 0 3 0 0 2 0 0 0 2 0 0 3 3 1 1 2 1
1 1 2 1 1 3 1 1 1 3 1 1 2 1 1 1 2 1 1 3 1 1 1 3 1 1 2 1 1 1 2 1 1 3 3 0 0 2 0 0 0
cycle 23 6 78
0 0 3 0 0 0 3 0 0 2 0 0 0 2 0 0 3 0 0 0 3 0 0 2 0 0 0 2 0 0 3 3 1 1 2 1
1 1 2 1 1 3 1 1 1 3 1 1 2 1 1 1 2 1 1 3 1 1 1 3 1 1 2 1 1 1 2 1 1 3 3 0 0 2 0 0 0 2
cycle 22 6 78
0 3 0 0 0 3 0 0 2 0 0 0 2 0 0 3 0 0 0 3 0 0 2 0 0 0 2 0 0 3 3 1 1 2 1
1 1 2 1 1 3 1 1 1 3 1 1 2 1 1 1 2 1 1 3 1 1 1 3 1 1 2 1 1 1 2 1 1 3 3 0 0 2 0 0 0 2 0
cycle 21 6 78
3 0 0 0 3 0 0 2 0 0 0 2 0 0 3 0 0 0 3 0 0 2 0 0 0 2 0 0 3 3 1 1 2 1
1 1 2 1 1 3 1 1 1 3 1 1 2 1 1 1 2 1 1 3 1 1 1 3 1 1 2 1 1 1 2 1 1 3 3 0 0 2 0 0 0 2 0 0
cycle 21 7 78
0 0 0 3 0 0 2 0 0 0 2 0 0 3 0 0 0 3 0 0 2 0 0 0 2 0 0 3 3 1 1 2 1
1 1 2 1 1 3 1 1 1 3 1 1 2 1 1 1 2 1 1 3 1 1 1 3 1 1 2 1 1 1 2 1 1 3 3 0 0 2 0 0 0 2 0 0 3
cycle 26 12 78
0 0 0 2 0 0 3 0 0 0 3 0 0 2 0 0 0 2 0 0 3 0 0 0 3 0 0 2 0 0 0 2 0 0 3 3 1 1 2 1
1 1 2 1 1 3 1 1 1 3 1 1 2 1 1 1 2 1 1 3 1 1 1 3 1 1 2 1 1 1 2 1 1 3 3 0 0 2
cycle 25 12 78
0 0 2 0 0 3 0 0 0 3 0 0 2 0 0 0 2 0 0 3 0 0 0 3 0 0 2 0 0 0 2 0 0 3 3 1 1 2 1
1 1 2 1 1 3 1 1 1 3 1 1 2 1 1 1 2 1 1 3 1 1 1 3 1 1 2 1 1 1 2 1 1 3 3 0 0 2 0
cycle 24 12 78
0 2 0 0 3 0 0 0 3 0 0 2 0 0 0 2 0 0 3 0 0 0 3 0 0 2 0 0 0 2 0 0 3 3 1 1 2 1
1 1 2 1 1 3 1 1 1 3 1 1 2 1 1 1 2 1 1 3 1 1 1 3 1 1 2 1 1 1 2 1 1 3 3 0 0 2 0 0
cycle 23 12 78
2 0 0 3 0 0 0 3 0 0 2 0 0 0 2 0 0 3 0 0 0 3 0 0 2 0 0 0 2 0 0 3 3 1 1 2 1
1 1 2 1 1 3 1 1 1 3 1 1 2 1 1 1 2 1 1 3 1 1 1 3 1 1 2 1 1 1 2 1 1 3 3 0 0 2 0 0 0
cycle 23 11 78
0 0 3 0 0 0 3 0 0 2 0 0 0 2 0 0 3 0 0 0 3 0 0 2 0 0 0 2 0 0 3 3 1 1 2 1
1 1 2 1 1 3 1 1 1 3 1 1 2 1 1 1 2 1 1 3 1 1 1 3 1 1 2 1 1 1 2 1 1 3 3 0 0 2 0 0 0 2
cycle 22 11 78
0 3 0 0 0 3 0 0 2 0 0 0 2 0 0 3 0 0 0 3 0 0 2 0 0 0 2 0 0 3 3 1 1 2 1
1 1 2 1 1 3 1 1 1 3 1 1 2 1 1 1 2 1 1 3 1 1 1 3 1 1 2 1 1 1 2 1 1 3 3 0 0 2 0 0 0 2 0
cycle 21 11 78
3 0 0 0 3 0 0 2 0 0 0 2 0 0 3 0 0 0 3 0 0 2 0 0 0 2 0 0 3 3 1 1 2 1
1 1 2 1 1 3 1 1 1 3 1 1 2 1 1 1 2 1 1 3 1 1 1 3 1 1 2 1 1 1 2 1 1 3 3 0 0 2 0 0 0 2 0 0
cycle 21 12 78
0 0 0 3 0 0 2 0 0 0 2 0 0 3 0 0 0 3 0 0 2 0 0 0 2 0 0 3 3 1 1 2 1
1 1 2 1 1 3 1 1 1 3 1 1 2 1 1 1 2 1 1 3 1 1 1 3 1 1 2 1 1 1 2 1 1 3 3 0 0 2 0 0 0 2 0 0 3
cycle 26 17 78
0 0 0 2 0 0 3 0 0 0 3 0 0 2 0 0 0 2 0 0 3 0 0 0 3 0 0 2 0 0 0 2 0 0 3 3 1 1 2 1
1 1 2 1 1 3 1 1 1 3 1 1 2 1 1 1 2 1 1 3 1 1 1 3 1 1 2 1 1 1 2 1 1 3 3 0 0 2
cycle 25 17 78
0 0 2 0 0 3 0 0 0 3 0 0 2 0 0 0 2 0 0 3 0 0 0 3 0 0 2 0 0 0 2 0 0 3 3 1 1 2 1
1 1 2 1 1 3 1 1 1 3 1 1 2 1 1 1 2 1 1 3 1 1 1 3 1 1 2 1 1 1 2 1 1 3 3 0 0 2 0
cycle 24 17 78
0 2 0 0 3 0 0 0 3 0 0 2 0 0 0 2 0 0 3 0 0 0 3 0 0 2 0 0 0 2 0 0 3 3 1 1 2 1
1 1 2 1 1 3 1 1 1 3 1 1 2 1 1 1 2 1 1 3 1 1 1 3 1 1 2 1 1 1 2 1 1 3 3 0 0 2 0 0
cycle 23 17 78
2 0 0 3 0 0 0 3 0 0 2 0 0 0 2 0 0 3 0 0 0 3 0 0 2 0 0 0 2 0 0 3 3 1 1 2 1
1 1 2 1 1 3 1 1 1 3 1 1 2 1 1 1 2 1 1 3 1 1 1 3 1 1 2 1 1 1 2 1 1 3 3 0 0 2 0 0 0
cycle 23 16 78
0 0 3 0 0 0 3 0 0 2 0 0 0 2 0 0 3 0 0 0 3 0 0 2 0 0 0 2 0 0 3 3 1 1 2 1
1 1 2 1 1 3 1 1 1 3 1 1 2 1 1 1 2 1 1 3 1 1 1 3 1 1 2 1 1 1 2 1 1 3 3 0 0 2 0 0 0 2
cycle 22 16 78
0 3 0 0 0 3 0 0 2 0 0 0 2 0 0 3 0 0 0 3 0 0 2 0 0 0 2 0 0 3 3 1 1 2 1
1 1 2 1 1 3 1 1 1 3 1 1 2 1 1 1 2 1 1 3 1 1 1 3 1 1 2 1 1 1 2 1 1 3 3 0 0 2 0 0 0 2 0
cycle 21 16 78
3 0 0 0 3 0 0 2 0 0 0 2 0 0 3 0 0 0 3 0 0 2 0 0 0 2 0 0 3 3 1 1 2 1
1 1 2 1 1 3 1 1 1 3 1 1 2 1 1 1 2 1 1 3 1 1 1 3 1 1 2 1 1 1 2 1 1 3 3 0 0 2 0 0 0 2 0 0
cycle 21 17 78
0 0 0 3 0 0 2 0 0 0 2 0 0 3 0 0 0 3 0 0 2 0 0 0 2 0 0 3 3 1 1 2 1
1 1 2 1 1 3 1 1 1 3 1 1 2 1 1 1 2 1 1 3 1 1 1 3 1 1 2 1 1 1 2 1 1 3 3 0 0 2 0 0 0 2 0 0 3